==========
==========
##########
# B  X X #
#      # #
#E   C C #
######   #
=====#####
==========
==========
